URL: stage.example.com
checksum: sha256:0675c9139782a58255b7aae4e8f4eec287509834d8488a4eb54485a880e4fdc1

deploy_user: deployuser
deploy_pass: !vault |
$ANSIBLE_VAULT;1.1;AES256
65326233363731663631646134306563353236653338646433343838373437373430376464616339
3333383233373465353131323237636538363361316431380a643336643862663739623631616530
35356361626434653066316661373863313362396162646365343166646231653165303431636139
6230366164363138340a356631633930323032653466626531383261613539633365366631623238
32396637623866633135363231346664303730353230623439633666386662346432363164393438
33653666373064326233373337383934316335303862313838383966623134646230346330303136
66333232363062303837333533303130386238323165623632346239383538343437663437373730
35666532333065383439